olivia	liam
liam	isabella
emma	emma
noah	noah
ava	sophia
oliver	mia
william	matthew
sophia	sebastian
isabella	camila
elijah	luna
james	dylan
charlotte	valentina
benjamin	jacob
amelia	sofia
lucas	victoria
mason	ethan
mia	ava
alexander	lucas
harper	olivia
henry	jayden
abigail	amelia
jacob	alaia
emily	mateo
ella	leah
michael	aiden
elizabeth	zoe
daniel	mason
camila	daniel
logan	genesis
luna	abigail
jackson	angel
sebastian	scarlett
sofia	logan
avery	emily
jack	alexander
mila	michael
aiden	ashley
aria	ariana
owen	gael
samuel	penelope
scarlett	isaac
matthew	david
penelope	samantha
layla	ian
joseph	aaron
chloe	charlotte
levi	oliver
victoria	hailey
mateo	gabriel
madison	mila
david	joshua
eleanor	chloe
grace	adrian
john	elias
nora	elijah
wyatt	elizabeth
riley	melanie
carter	thiago
julian	allison
luke	ryan
zoey	josiah
grayson	madison
hannah	gianna
hazel	samuel
isaac	bella
lily	elena
jayden	axel
ellie	amaya
lillian	amy
gabriel	joseph
zoe	kaylee
anthony	anthony
dylan	grace
stella	valerie
aurora	julian
leo	alexa
natalie	luis
lincoln	emilia
emilia	gabriella
jaxon	jeremiah
asher	eliana
everly	arya
christopher	nicholas
josiah	brianna
leah	christopher
aubrey	daniela
andrew	christian
willow	kimberly
thomas	jonathan
addison	riley
joshua	benjamin
ezra	maya
