olivia	ava
liam	noah
emma	amir
noah	madison
ava	liam
oliver	skylar
william	riley
sophia	mason
isabella	elijah
elijah	amelia
james	king
charlotte	olivia
benjamin	josiah
amelia	zuri
lucas	aiden
mason	isabella
mia	fatoumata
alexander	ethan
harper	serenity
henry	jayden
abigail	zoey
jacob	carter
emily	chloe
ella	zion
michael	aria
elizabeth	jeremiah
daniel	fatima
camila	amari
logan	leah
luna	melody
jackson	messiah
sebastian	amina
sofia	joshua
avery	mariam
jack	kayden
mila	nova
aiden	kyrie
aria	aaliyah
owen	legend
samuel	brielle
scarlett	layla
matthew	kairo
penelope	mia
layla	michael
joseph	grace
chloe	nyla
levi	bryson
victoria	sophia
mateo	ryan
madison	aisha
david	mohamed
eleanor	christian
grace	kylie
john	daniel
nora	miracle
wyatt	wynter
riley	cairo
carter	autumn
julian	logan
luke	adonis
zoey	kayla
grayson	kaiden
hannah	karter
hazel	kehlani
isaac	reign
lily	cameron
jayden	david
ellie	savannah
lillian	chase
gabriel	abigail
zoe	aminata
anthony	nasir
dylan	amira
stella	ibrahim
aurora	harmony
leo	isaiah
natalie	leilani
lincoln	aaron
emilia	naomi
jaxon	zoe
asher	jace
everly	jayce
christopher	ariah
josiah	samuel
leah	bella
aubrey	gianna
andrew	ayden
willow	nevaeh
thomas	ashton
addison	phoenix
joshua	taylor
ezra	caleb
