olivia	ethan
liam	chloe
emma	lucas
noah	olivia
ava	aiden
oliver	muhammad
william	jayden
sophia	mia
isabella	emma
elijah	ryan
james	sophia
charlotte	jasper
benjamin	amelia
amelia	liam
lucas	charlotte
mason	daniel
mia	noah
alexander	mason
harper	emily
henry	leo
abigail	grace
jacob	william
emily	isabella
ella	ella
michael	ayaan
elizabeth	evan
daniel	nathan
camila	ava
logan	alexander
luna	evelyn
jackson	jason
sebastian	hannah
sofia	oliver
avery	aria
jack	henry
mila	bella
aiden	hailey
aria	mohammad
owen	austin
samuel	kyle
scarlett	sarah
matthew	arya
penelope	aaron
layla	claire
joseph	ellie
chloe	arham
levi	dylan
victoria	eric
mateo	justin
madison	fatima
david	kayla
eleanor	matthew
grace	maryam
john	andrew
nora	zoe
wyatt	ibrahim
riley	audrey
carter	abdullah
julian	abigail
luke	adam
zoey	anna
grayson	avery
hannah	ian
hazel	alyssa
isaac	maya
lily	james
jayden	alice
ellie	benjamin
lillian	celine
gabriel	emilia
zoe	tenzin
anthony	inaaya
dylan	jasmine
stella	logan
aurora	riley
leo	owen
natalie	sofia
lincoln	theodore
emilia	tenzin
jaxon	jacob
asher	zoey
everly	ayden
christopher	alina
josiah	fiona
leah	kai
aubrey	joanna
andrew	kevin
willow	jonathan
thomas	anaya
addison	annie
joshua	george
ezra	ayesha
